    0  1  2  3  4  5  6  7
  +------------------------+
0 | .  .  .  .  .  .  .  a |
1 | .  2  1  .  .  .  .  . |
2 | .  .  .  .  .  .  .  . |
3 | .  .  .  .  .  .  .  d |
4 | .  .  .  .  .  .  .  . |
5 | .  .  .  .  .  .  .  c |
6 | .  .  .  .  .  .  .  . |
7 | .  .  .  .  .  .  .  e |
  +------------------------+