    0  1  2  3  4  5  6  7
  +------------------------+
0 | .  .  .  .  .  .  .  . |
1 | 2  .  1  .  .  .  .  a |
2 | .  .  .  .  b  d  .  . |
3 | .  .  .  .  .  .  .  . |
4 | .  .  .  .  .  .  .  c |
5 | .  .  .  .  .  .  .  . |
6 | .  .  .  .  .  .  .  e |
7 | .  .  .  .  .  .  .  . |
  +------------------------+