    0  1  2  3  4  5  6  7
  +------------------------+
0 | .  .  .  .  .  .  .  . |
1 | .  2  1  .  b  .  a  . |
2 | .  .  .  .  .  .  .  . |
3 | .  .  .  .  .  .  d  . |
4 | .  .  .  .  .  .  .  . |
5 | .  .  .  .  .  .  .  c |
6 | .  .  .  .  .  .  .  . |
7 | .  .  .  .  .  .  .  e |
  +------------------------+